{
  "code": 241,
  "message": "Map found.",
  "cityName": "Skolwin",
  "map": [
    [".", ".", ".", ".", ".", ".", ".", ".", "W", "W"],
    [".", ".", ".", ".", ".", ".", ".", "W", "W", "."],
    [".", "T", ".", ".", ".", ".", "W", "W", ".", "."],
    [".", ".", ".", ".", ".", ".", "W", ".", ".", "."],
    [".", ".", "T", ".", ".", ".", "W", ".", "G", "."],
    [".", ".", ".", ".", "R", ".", "W", ".", ".", "."],
    [".", ".", ".", "R", "R", ".", "W", "W", ".", "."],
    ["S", "R", ".", ".", ".", ".", ".", "W", ".", "."],
    [".", ".", ".", ".", ".", ".", "W", "W", ".", "."],
    [".", ".", ".", ".", ".", "W", "W", ".", ".", "."]
  ]
}
